À à	A a
Á á	B b
Â â	V v
Ã ã	G g
Ä ä	D d
Å å	Ye ye
Æ æ	Zh zh
Ç ç	Z z
È è	I i
É é	Y y
Ê ê	K k
Ë ë	L l
Ì ì	M m
Í í	N n
Î î	O o
Ï ï	P p
Ð ð	R r
Ñ ñ	S s
Ò ò	T t
Ó ó	U u
Ô ô	F f
Õ õ	Kh kh
Ö ö	Ts ts
× ÷	Ch ch
Ø ø	Sh sh
Ù ù	Shch shch
Ú ú	' '
Û û	Y y
Ü ü ' '
Ý ý	E e
Þ þ	Yu yu
ß ÿ	Ya ya